00000000000000000000
0,,oo,,,0R0,o,,,0,,,
,,,,,,,,,.,,,,,,,,,,
,,,,,,,,,.,,,,,T,,,,
,,T,,,,,,.,,,,,,,,,,
,,,,,,,,,.,,,,,,,o,,
,,,,T,,,,..,,,,,,,,,
,,,,,,o,,,.,,o,,,,,,
....................
....................
,,o,,,,,,,,,,,o,,,,,
,,,,,,,,,,,,,,,,T,,,
,,,,T,T,,,,,,,,,,,,,

